# Spanish Basics - Common words and phrases
# Format: front<TAB>back
Hello	Hola
Goodbye	Adios
Please	Por favor
Thank you	Gracias
Yes	Si
No	No
Good morning	Buenos dias
Good night	Buenas noches
How are you?	Como estas?
I don't understand	No entiendo
Water	Agua
Food	Comida
Friend	Amigo / Amiga
Book	Libro
House	Casa
Cat	Gato
Dog	Perro
One	Uno
Two	Dos
Three	Tres
